###=================#########
#===###################===#=#
#=####================#=#=#=#
#=###################=#=#=#=#
#=====================#=#=#=#
#####################=#=#=#=#
#===##================#=#=#=#
#=#=##=###=##=#########=#=#=#
#=#====#===##E#=========#=#=#
#=#=##=################=#=#=#
###=##=============####=#=#=#
###=##############=##=#=#=#=#
###================##=#=#=#=#
######=########=#######=#=#=#
######=####=============#===#
S======######################
